1 1 1 1 1 1 1 1 1 1 1 1 1 1 1 1
1 0 0 0 0 0 0 0 0 0 0 0 0 0 0 1
1 0 3 5 4 2 3 2 2 6 2 5 5 4 0 1
1 0 2 4 6 2 2 6 2 2 2 2 3 3 0 1
3 0 2 6 3 3 6 4 2 4 6 6 3 2 0 3
3 0 2 4 2 6 6 4 4 2 6 2 6 6 0 3
3 0 3 2 6 2 3 6 2 6 2 2 3 2 0 3
1 0 6 3 3 6 2 2 6 2 2 2 3 4 0 1
1 0 2 2 4 4 2 4 3 2 6 6 6 4 0 1
1 0 4 2 3 6 2 2 3 2 6 2 6 2 0 1
1 0 0 0 0 0 0 0 0 0 0 0 0 0 0 1
1 1 1 1 1 1 1 1 1 1 1 1 1 1 1 1
