1 1 1 1 1 1 1 1 12 1 1 1 1 1 1 1 1
1 0 0 0 0 0 0 0 0 0 0 0 0 0 0 1
1 0 6 5 4 5 4 6 4 5 4 4 6 6 0 1
1 0 4 3 2 2 2 4 3 2 6 6 4 3 0 1
1 0 4 6 6 2 2 2 2 4 3 2 3 3 0 1
1 0 3 2 3 3 3 2 3 6 2 2 2 2 0 1
1 0 2 4 2 2 2 2 4 2 2 2 4 6 0 1
1 0 3 3 4 2 4 2 3 2 6 3 4 2 0 1
1 0 6 2 2 2 2 2 4 6 2 3 3 2 0 1
1 0 4 2 2 2 6 2 2 4 4 2 2 3 0 1
1 0 0 0 0 0 0 0 0 0 0 0 0 0 0 1
1 1 1 1 1 1 1 1 1 1 1 1 1 1 1 1
