11 11 11 11 11 11 11 11 11 11 11 11 11 11 11 11
0 0 0 0 0 0 0 0 0 0 0 0 0 0 0 0
1 1 1 1 1 1 1 1 1 1 1 1 1 1 1 1
1 1 1 1 1 1 1 1 1 1 1 1 1 1 1 1
1 1 1 1 1 1 1 1 1 1 1 1 1 1 1 1
1 1 1 1 1 1 1 1 1 1 1 1 1 1 1 1
1 1 1 1 1 1 1 1 1 1 1 1 1 1 1 1
12 12 12 12 12 12 12 12 12 12 12 12 12 12 12 12
12 12 12 12 5 5 5 5 5 5 5 5 12 12 12 12
12 12 12 5 16 16 16 16 16 16 16 16 5 12 12 12
12 12 5 16 16 16 16 16 16 16 16 16 16 5 12 12
12 5 16 16 16 16 16 16 16 16 16 16 16 16 5 12
