1 1 1 1 1 1 1 1 1 1 1 1 1 1 1 1
1 0 0 0 0 0 0 0 0 0 0 0 0 0 0 1
1 0 6 2 2 4 4 2 5 5 5 6 5 6 0 1
1 0 6 3 2 2 2 6 3 3 3 6 6 3 0 1
3 0 6 4 3 3 2 3 4 2 4 2 4 2 0 3
3 0 3 4 2 2 4 4 4 6 4 6 2 2 0 3
3 0 6 3 2 2 2 4 2 2 2 2 2 4 0 3
1 0 4 2 4 4 2 4 6 6 6 4 4 3 0 1
1 0 6 6 2 4 6 2 6 6 6 3 6 2 0 1
1 0 2 4 6 2 4 4 3 4 2 2 3 3 0 1
1 0 0 0 0 0 0 0 0 0 0 0 0 0 0 1
1 1 1 1 1 1 1 1 1 1 1 1 1 1 1 1
