1 1 1 1 1 1 1 1 12 1 1 1 1 1 1 1 1
1 0 0 0 0 0 0 0 0 0 0 0 0 0 0 1
1 0 4 2 6 5 6 4 6 5 6 5 5 5 0 1
1 0 3 3 4 3 2 6 6 3 4 2 2 6 0 1
1 0 4 2 2 4 2 6 4 4 4 2 6 4 0 1
1 0 6 2 4 4 2 2 6 2 2 4 2 2 0 1
1 0 3 4 2 6 4 4 6 4 2 4 2 6 0 1
1 0 4 3 2 4 3 6 3 4 3 2 2 6 0 1
1 0 4 4 2 6 4 2 3 6 3 6 4 6 0 1
1 0 6 4 3 2 2 4 6 2 6 4 2 2 0 1
1 0 0 0 0 0 0 0 0 0 0 0 0 0 0 1
1 1 1 1 1 1 1 1 1 1 1 1 1 1 1 1
